11111111111111111111
10010000000CCC000011
100001111110C0011001
100011C000000111E001
11111111111111111111