11111111111111111111
1001000A000CCC000011
100001111110C0011001
1P0011C1000001110C11
100011C000000111E001
11111111111111111111