ST1111111111111ART
10010000000C1
1000011111001
1P0011E000001
10010000000C1
1000011111001
1P0011E000001
EN1111111111111D