111111111111111111
10001C000000000R01
101R1C000000100001
100000001000010001
10111R000R11100001
10000C000000C00001
100000011110100001
10C0000P0000000001
110CC0010000000001
1000000E0000000001
10C000000011000C01
111111111111111111