1111111111111111111111111111111111
1E00R000000R000C00000C000000000001
10100101001R0000101001000000010101
1010010010101010001001R00000010101
1P0000000C00C0R00000000000000000C1
1111111111111111111111111111111111