11111111111111111111
10R10000000CCC000011
1000011R1110C0011001
1P0011C1000001110011
100011C000000111E001
11111111111111111111