11111111111111111111
10R10000000CCC000011
100001111110C0011001
1P0011C000000111E001
11111111111111111111